###############   #  #   ###############
#. . . . . . .# @ #  #   #. . . . . . .#
#             #   ####   #             #
#   ######                    ######   #
#     ##                        ##     #
#     ##    ...............     ##     #
# . . . . . . . . . . . . . . . . . .  #
#           ###############            #
# . . . . . . . . . . . . . . . . . .  #
# . . . . . . . . . . . . . . . . . .  #
#                                      #
#  #####    #####     #####     #####  #
#     ## ...................... ##     #
#     ## ...................... ##     #
###   ## ...#####     #####.... ##   ###
         ...#      C      #....
   &     ...#             #....    =
###   ## ...###############.... ##   ###
#     ## ...................... ##     #
#     ## ...................... ##     #
#  #####    #####     #####     #####  #
#                                      #
# . . . . . . . . . . . . . . . . . .  #
# . . . . . . . . . . . . . . . . . .  #
#            ###############           #
# . . . . . . . . . . . . . . . . . .  #
#     ##    ...............     ##     #
#     ##                        ##     #
#   ######                    ######   #
#             #   ####   #             #
#. . . . . . .#   #  # $ #. . . . . . .#
###############   #  #   ###############